XXXXXXXXXXXXXXXXXXXXXXXXX
X H               XXX   X
X X XXX     XXX       X X                        
X X X              X    X
X   X X X   XXX  X X XX X
  X          XXX        X
 XXX XX X    XXX        X
  X                     X
X   X X X       XXX     X
XXXF  F X       XXX     X
XXX XXX X               X
XXX XXX X    XXX        X
XXX     X    XXX        X
XXXXXXXXXXXXXXXXXXXXXXXXX